111111
1001E1
100011
10CP01
111111